111111111
10CCCCEC1
10C11CCC1
1C0C11C01
1000CCPX1
111111111